EEEEEEEEEEEEEE
EEEEEEEEEEEEEE
EEEEMMMMMEEEEE
EEEEMBBBMEEEEE
EEEEMBBBMEEEEE
EEMMMBBBMMMMEE
EEMBBBBBBBBMEE
EEMBBBVBBBBMEE
EEMBBBBBBBBMEE
EEMMMBBBMMMMEE
EEEEMBBBMEEEEE
EEEEMMMMMEEEEE
EEEEEEEEEEEEEE
EEEEEEEEEEEEEE