EEEEEEEEEEEEEE
EEEEEEEEEEEEEE
EEEEEEEEEEEEEE
EEMMMMMEEEEEEE
EEMBBBMMEEEEEE
EEMBBVBMEEEEEE
EEMMMVVMMMEEEE
EEMMVBBBVMMMEE
EEMVVVBVVVVMEE
EEMVVMMMVMMMEE
EEMMMMEMMMEEEE
EEEEEEEEEEEEEE
EEEEEEEEEEEEEE
EEEEEEEEEEEEEE