EEEEEEEEEEEEEE
EEEEEEEEEEEEEE
EEEEEMMMMMEEEE
EEEEMMBBBMMEEE
EEEMMBBBBBMMEE
EEEMBBBBBBBMEE
EEEMBBBVBBBMEE
EEEMBBBBBBBMEE
EEEMMBBBBBMMEE
EEEEEMBBBMMEEE
EEEEEMMMMMEEEE
EEEEEEEEEEEEEE
EEEEEEEEEEEEEE
EEEEEEEEEEEEEE