EEEEEEEEEEEEEE
EEEEEEEEEEEEEE
EEEEEEEEEEEEEE
EEEEEEEEEEEEEE
EEEEMMMMMMEEEE
EEEEMBBBBMEEEE
EEEEMVBBBMEEEE
EEEEMVVBBMEEEE
EEEEMVVVBMEEEE
EEEEMMMMMMEEEE
EEEEEEEEEEEEEE
EEEEEEEEEEEEEE
EEEEEEEEEEEEEE
EEEEEEEEEEEEEE