EEEEEEEEEEEEEE
EEEEEEEEEEEEEE
EEEEMMMMMEEEEE
EEEEMBBBMEEEEE
EEMMMBBBMMMEEE
EEMBBBBBBBMEEE
EEMBBBVBBBMEEE
EEMBBBBBBBMEEE
EEMMMBBBMMMEEE
EEEEMBBBMEEEEE
EEEEMMMMMEEEEE
EEEEEEEEEEEEEE
EEEEEEEEEEEEEE
EEEEEEEEEEEEEE