EEEEEEEEEEEEEE
EEEEEEEEEEEEEE
EEMMMMMMMMMMEE
EEMVBBVVBBVMEE
EEMVBBVVBBVMEE
EEMMMVBBVMMMEE
EEEEMMBBMMEEEE
EEEEEMVVMEEEEE
EEEEEMBBMEEEEE
EEEEEMBBMEEEEE
EEEEEMVVMEEEEE
EEEEEMMMMEEEEE
EEEEEEEEEEEEEE
EEEEEEEEEEEEEE