EEEEEEEEEEEEEE
EEEEEEEEEEEEEE
EEEEEEMMMEEEEE
EEEEEMMBMMEEEE
EEEEMMBBBMMEEE
EEEMMBBBBBMMEE
EEMMBBBBBBBMME
EEMBBBBVBBBBME
EEMMBBBBBBBMME
EEEMMBBBBBMMEE
EEEEMMBBBMMEEE
EEEEEMMBMMEEEE
EEEEEEMMMEEEEE
EEEEEEEEEEEEEE