EEEEEEEEEEEEEE
EEEEEEEEEEEEEE
EEEEEEEEEEEEEE
EEEMMMMMMMMEEE
EEEMBBMMBBMEEE
EEEMBBMMBBMEEE
EEEMVVVVVVMEEE
EEEMVVVVVVMEEE
EEEMBBMMBBMEEE
EEEMBBMMBBMEEE
EEEMMMMMMMMEEE
EEEEEEEEEEEEEE
EEEEEEEEEEEEEE
EEEEEEEEEEEEEE