MMMMMMMMMMMMMM
MMMVVVMMVVVMMM
MMVVVVMMVVVVMM
MVVVVVMMVVVVVM
MVVVVVMMVVVVVM
MBVVVVMMVVVVVM
MVBVBBVVBBVVVM
MVVBBBVVBBVVVM
MBVVVVMMVVVVVM
MVBBVBMMVVVVVM
MVVVBVMMVVVVVM
MMVVVVMMVVVVMM
MMMVVVMMVVVMMM
MMMMMMMMMMMMMM