EEEEEEEEEEEEEE
EEEEEEEEEEEEEE
EEEEEEEEEEEEEE
EEEEMMMMEEEEEE
EEEMMVVMMMMEEE
EEEMVVVBBVMEEE
EEEMMVBVBMMEEE
EEEEMMBBMMEEEE
EEEEEMVBMMEEEE
EEEEEMVVVMEEEE
EEEEEMMMMMEEEE
EEEEEEEEEEEEEE
EEEEEEEEEEEEEE
EEEEEEEEEEEEEE